11
8
3 34 34 34 34 34 34 34 34 34 4 
38 0 0 0 0 0 0 0 0 0 38 
37 0 0 0 0 0 0 0 0 0 37 
37 0 0 0 0 0 0 0 0 0 37 
37 0 0 0 0 0 0 0 0 0 37 
37 0 0 0 0 0 0 0 0 0 37 
36 0 0 0 0 0 0 0 0 0 36 
30 33 34 33 34 33 34 33 34 33 30 
