100
22
32 30 32 32 30 32 32 32 32 31 32 30 30 31 32 32 30 30 32 32 32 31 32 30 32 31 32 30 32 32 31 30 32 32 31 31 32 32 30 30 32 31 32 32 30 32 32 31 30 32 30 32 31 32 30 31 32 32 30 32 31 32 31 31 31 32 31 30 30 30 32 32 30 30 30 30 30 30 31 32 31 32 31 31 32 31 31 31 31 31 31 31 32 31 31 31 32 31 31 31 
32 30 32 30 31 32 31 37 0 0 0 0 0 0 0 0 32 32 30 32 32 32 32 32 32 32 0 0 0 0 0 0 32 32 32 32 32 30 32 0 0 0 0 0 0 0 0 0 0 0 0 0 32 31 32 31 30 32 30 32 31 32 32 32 32 32 31 31 32 32 30 32 32 30 32 30 30 30 31 32 31 31 32 32 32 31 32 32 32 31 32 31 32 32 31 32 32 32 31 31 
32 32 31 31 32 32 32 37 0 0 0 0 0 0 0 0 0 32 32 30 31 32 32 0 0 0 0 0 0 0 0 0 30 32 31 32 32 30 31 0 0 0 0 0 0 0 0 0 0 0 0 0 30 30 32 30 32 32 31 32 31 32 31 30 31 31 31 32 32 30 32 31 31 30 32 32 30 30 31 31 31 32 31 30 31 32 30 32 31 31 32 31 32 32 32 31 31 32 31 30 
30 32 32 32 32 31 32 37 0 0 0 0 0 0 0 0 0 0 31 32 30 32 0 0 0 0 0 0 0 0 0 0 32 32 30 31 32 32 32 0 0 0 0 0 0 0 0 0 0 0 0 0 32 31 32 32 32 32 32 32 32 32 31 32 31 30 31 30 32 31 32 30 32 32 32 30 30 30 31 31 31 32 30 32 31 32 32 31 31 32 32 30 31 31 32 30 31 31 31 31 
32 32 31 32 32 32 32 36 0 0 0 0 0 0 0 0 0 0 0 0 0 0 0 0 32 32 0 0 0 0 0 0 31 32 32 32 31 32 32 0 0 0 0 0 0 0 0 0 0 0 0 0 0 0 0 0 0 0 0 0 0 30 32 32 31 31 31 30 30 32 31 32 32 30 30 30 30 30 31 31 32 31 32 30 32 32 31 32 32 32 31 31 32 31 32 32 31 31 31 31 
32 30 31 32 30 31 32 32 32 31 32 31 32 32 0 0 0 0 0 0 0 0 0 32 32 32 0 0 0 0 0 0 31 32 30 32 32 32 32 0 0 0 0 0 0 0 0 0 0 0 0 0 0 0 0 0 0 0 0 0 0 32 31 32 31 30 32 30 32 32 32 32 30 31 31 31 32 31 31 31 31 32 32 32 31 31 31 32 31 32 30 31 31 32 31 32 31 31 31 30 
32 31 30 30 30 32 32 32 32 32 32 32 32 32 32 31 32 30 30 30 32 32 30 32 31 32 32 30 32 0 0 31 30 30 32 32 30 31 32 0 0 0 0 0 0 32 31 32 31 30 32 32 30 32 31 31 0 0 32 30 32 32 30 30 31 30 32 31 32 32 30 30 30 31 0 0 0 0 0 0 0 0 0 0 0 0 0 0 0 0 0 0 0 0 0 0 0 0 31 30 
31 32 32 32 32 32 32 30 32 30 32 32 31 32 31 32 32 30 32 32 30 32 31 31 32 32 0 0 0 0 0 32 32 31 32 32 31 32 30 0 0 0 0 0 0 32 32 30 32 32 32 30 32 31 30 32 0 0 32 30 31 32 30 32 32 30 31 30 32 32 30 30 30 32 0 0 0 0 0 0 0 0 0 0 0 0 0 0 0 0 0 0 0 0 0 0 0 0 32 30 
0 0 0 32 32 32 32 32 32 32 32 32 32 32 30 32 30 30 31 32 30 30 32 32 32 0 0 0 0 0 0 32 32 0 0 0 0 0 0 0 0 0 0 0 0 32 32 32 32 32 32 32 32 32 32 32 0 0 30 30 31 32 31 31 31 32 31 30 30 30 30 30 30 32 0 0 0 0 0 0 0 0 0 0 0 0 0 0 0 0 0 0 0 0 0 0 0 0 31 32 
0 0 0 32 32 32 32 32 31 32 32 32 32 32 30 32 31 32 32 31 30 32 32 32 32 0 0 0 0 32 32 32 0 0 0 0 0 0 0 0 0 0 0 32 32 31 30 31 30 30 32 31 30 30 32 32 0 0 32 30 32 30 30 32 32 31 31 31 30 32 30 32 30 31 0 0 0 0 0 0 0 0 0 0 0 0 0 0 0 0 0 0 0 0 0 0 0 0 32 30 
0 0 0 32 32 32 32 32 32 32 32 32 31 32 32 32 31 32 32 32 31 32 32 31 32 0 0 0 0 0 0 0 0 0 0 0 0 0 0 0 0 0 0 32 31 32 30 30 32 30 30 32 30 30 32 32 0 0 32 30 32 30 32 30 30 32 30 32 31 32 31 30 32 32 0 0 0 0 0 0 0 0 0 0 0 0 0 0 0 0 0 0 0 0 0 0 0 0 32 30 
0 0 0 32 32 32 32 32 31 32 32 32 31 32 30 32 32 30 32 32 32 31 30 32 31 32 0 0 0 0 0 0 0 0 0 30 30 0 0 32 31 0 0 32 32 32 30 30 30 31 30 32 30 32 32 32 0 0 30 32 30 30 32 31 32 30 31 32 32 30 31 30 32 32 0 0 0 0 0 0 0 0 0 0 0 0 0 0 0 0 0 0 0 0 0 0 0 0 32 31 
0 0 0 32 32 32 32 32 32 32 32 32 32 32 32 31 32 32 32 30 32 32 32 32 32 32 32 31 30 30 32 32 31 30 32 31 31 32 30 31 32 32 32 31 32 32 32 31 32 32 32 32 30 31 32 30 0 0 32 32 30 30 32 32 31 31 30 31 30 31 31 32 32 32 0 0 0 0 0 0 0 0 0 0 0 0 0 0 0 0 0 0 0 0 0 0 0 0 32 31 
0 0 0 0 0 0 0 0 0 0 0 0 0 0 0 0 0 0 0 32 30 32 32 32 32 32 32 32 32 32 30 32 32 32 32 32 31 31 32 32 32 32 32 32 32 32 32 32 32 32 30 32 30 30 32 30 0 0 32 32 31 32 30 32 30 30 31 32 31 32 32 30 32 32 0 0 0 0 0 0 0 0 0 32 32 31 32 31 32 32 30 32 32 32 31 32 30 30 32 31 
0 0 0 0 0 0 0 0 0 0 0 0 0 0 0 0 0 0 0 32 32 32 32 30 32 30 32 31 32 31 32 32 32 32 32 30 32 32 32 31 32 31 32 32 32 32 31 32 32 31 30 32 30 30 30 30 0 0 32 31 31 30 30 30 30 32 30 30 31 30 32 31 32 32 0 0 0 0 0 0 0 0 0 32 32 32 32 32 31 30 31 32 32 31 32 32 32 32 30 32 
0 0 0 0 0 0 0 0 0 0 0 0 0 0 0 0 0 0 0 32 30 30 32 32 32 30 32 32 32 32 32 32 31 32 32 30 30 32 32 31 32 31 32 32 31 32 30 32 32 32 31 30 32 31 30 30 0 0 31 32 32 32 0 0 0 0 0 0 0 0 0 30 32 32 0 0 0 0 0 0 0 32 32 32 32 31 30 32 30 32 31 32 31 32 31 30 32 32 32 32 
0 0 0 0 0 0 0 0 0 0 0 0 0 0 0 0 0 0 0 32 32 32 32 32 32 31 31 32 32 31 32 32 31 32 32 32 32 30 32 31 32 32 30 32 32 32 32 32 32 30 31 32 32 31 30 32 0 0 0 0 0 0 0 0 0 0 0 0 0 0 0 32 32 32 0 0 0 0 0 0 0 30 32 32 32 32 32 30 30 32 32 32 32 32 30 32 32 30 32 32 
0 0 0 0 0 0 0 0 0 0 0 0 0 0 0 0 0 0 0 32 32 32 32 32 30 32 32 32 32 32 32 32 32 32 32 32 32 32 32 32 32 32 30 30 32 32 32 32 32 31 32 30 30 31 31 32 0 0 0 0 0 0 0 0 0 0 0 0 0 0 0 0 0 0 0 0 0 0 0 32 32 30 30 30 30 32 32 32 32 32 32 32 32 31 30 31 30 31 32 32 
0 0 0 0 0 0 0 0 0 0 0 0 0 0 0 0 0 0 0 0 0 0 0 0 0 0 0 0 0 0 0 0 0 0 0 0 0 0 0 0 0 0 0 0 0 0 0 0 0 0 30 30 32 31 32 30 0 0 0 0 0 0 0 0 0 0 0 0 0 0 0 0 0 0 0 0 0 0 0 32 32 32 30 30 31 32 32 31 31 30 32 32 32 31 32 32 32 32 32 32 
0 0 0 0 0 0 0 0 0 0 0 0 0 0 0 0 0 0 0 0 0 0 0 0 0 0 0 0 0 0 0 0 0 0 0 0 0 0 0 0 0 0 0 0 0 0 0 0 0 0 0 32 30 32 30 32 0 0 0 0 0 0 0 0 0 0 0 0 0 0 0 32 32 32 31 32 32 32 32 32 31 32 32 32 31 32 32 32 32 30 32 30 30 32 32 32 32 32 32 32 
0 0 0 0 0 0 0 0 0 0 0 0 0 0 0 0 0 0 0 0 0 0 0 0 0 0 0 0 0 0 0 0 0 0 0 0 0 0 0 0 0 0 0 0 0 0 0 0 0 0 0 32 32 32 32 32 32 32 32 30 32 32 31 32 32 30 30 30 0 0 0 30 32 31 32 31 31 32 32 30 30 31 31 31 32 30 30 31 32 32 32 32 32 31 32 31 30 32 32 32 
0 0 0 0 0 0 0 0 0 0 0 0 0 0 0 0 0 0 0 0 0 0 0 0 0 0 0 0 0 0 0 0 0 0 0 0 0 0 0 0 0 0 0 0 0 0 0 0 0 0 0 32 32 32 31 30 32 32 31 30 32 32 30 31 32 30 31 32 0 0 0 32 32 32 32 32 32 30 32 32 32 30 32 32 32 32 32 32 32 32 30 32 32 32 32 32 32 32 32 32 
